0000000000000000000000000000000000000000000000000001aa0000000000000000000000100000
1111110001111111111111111111111111111111111111111111111111111111111100001100010010
000000000000000000000000000000000000000000011000000000000000000000000011111p010000
000000000000000000000000000000000f000000000a1000000000000000000f000i0000001p010000
0000000000000000000000000000000000000000011110000110000000000000001100000010010000
000000000000000000000aa0a00000000000000000000a000000000000001000000000000010000000
0000000000000110000000000011000000001100000001000000000000111000050000000000000000
000000000000aa00000000000000000001110000000000000000000000001111000000000000000000
000000000000000000001000000110000000000f000000000000000550000000000000000000000000
000000000f000000001111110000000000000000000000000050000000000000000000110000000000
00000000000000000000ip000000000f0000000000i000000000055000000f00000001001000000001
1555551111001100111111000011111111100500111001111005000001111111111000000000111111