00000000000000000000000000000000000000000000000000330000000000000000444444000000000000000044440000000000000000400000044000000444000000000444000000000000000000000
00000000000000000000000000000000000000000000000000330000000000000000000000000000do000000000000000000b0p00000000000000000000o0000000000000000000000000000000000000
000000000000000000000000000000000000000000000000003300000000000ac00000000000000d333330033333333337733333377333337733333003333377333333003333333333330033333333333
0000000000b00000000000000000000d000000c0000kc0000000000000700333330000000000d0d3300000000f00000000000000000000000000000000000000000000000000000000000000000003333
00000000000000000000000770007700770p07700007700000000000000000030g00000000000d33300000000000000i000a000o000000d00d00000000o000d0000d0000000000000000000000i0n3333
00000000000000000000000000000000000000000000000033333330000000030000033300000333300333333377733330033333333300333337733333333333003333333337777333333333333333333
00000000000000000g0i00000000000000000000000000000033300007000003p0000030000033333000000000000000000000p00000000000000000000p00000000000000000000000000p0333333333
000000000003333333330d0000000000000000000003300000333000000003333300033300033333300j000000c0000a0000000000f000000dc0000000000i0000j00cd0000000000k000000333333333
000000003000000000000d00000000000000d0000000000033333330000000000000000000333333333300333333300337733333333337733333333330033333337733333333337733333333333333333
000000000a0000000c000d0000000000000a00000000000000o000000033000000000000033333333p00000000000000000000000000000000000000000000000000000000000000000003333333j3333
00000030003000000c000d00003000000000000033000000000000000000000003300000333333333p000000000000000a0000000o00000b00000j00000d000o000i00000c0000000d00p333333333k33
33333333333333333333333333333333333300000000000333333337700000000000003333333333333333333333333333333333333333333333333333333333333333333333333333333333333333333