0000220000000000000p2200000000220000000000000000000022000000000000000000000000000000000000000022000000022
0000220000000000000p220000000022000000000000a00b000022000000000000000000000000000000000000000220f0000022
000022000000000000222222000000220000000000022222200022000000f00000000002200220000000000a00000002000000022
00002200000200000022222200000022000000000002222220002200000000000060060220022000j002222220000000000000o22
0000000000000000000000000000002200000066000002200000220000000000000000022002200220022n0000000000000000000
000000002600000000f00f00000000200000000j0000022000002200600660000j000002200220022002266626000000000000000
000000000f00000000000000000000000000006600000220000022000000000000000002200220022002200p2000000000000000i
00000000000060000022222200000000000i000000000220000022000000000022000002200220022002200p20000000000200022
000000000000000000222222000000000222222000000220002222220000000000000002200220022000200220000000002200022
000000000000000000002200000000000222222000000220002222220000002000000002200220022000002220000000002200022
000000000200222000002200002220000002200000000220000000000002200000000002200220022002222220000022002200022
222220002200000000002200000000000002200000000226666666666600000000000002200220022002200000000022002200022