000000000000000000000000000000000000000000000000000000000000000222222222222222222222222222
000000022000000000000000000000000000000000000000000000000000000002222222222222222222222222
000000022000000b00000000000000b0a0000000000000p0000000222000000aan222222222222222222222222
000000000000000100001001000011111100000000000000000000202005000222222222222222222222222222
000000000000000100000000000000000000005000011000110000222000000222222222222222222222222222
000002000000001000000000000000000000000000000001115000000000000022222222222222222222222222
0000000000010000000000000000055000000000f0000000000000b00000000000000022222222222222222222
000000000001000000020000000005500500000000000000000011500000000000001100000000000000000222
00000110000100000010000f0000220000000005555550000222220000000a0000001100000000000000000000
0000000010000000010000000000000000000000000000022222220000000000550000000000005500000000aa
00000000100000001000000000a0000000b0a00000002222222222200000000000000000000000000ii0000022
111111111111111111000050011111115555522222222222222222222222222222222222522222222222222222