00000000000000000000000000000000000000000000000000000000000000000300000000000000000000000000000000000000000000000000000000000000000000000000000bbb000000bbb0000p
333333333333333333333330000000000000000c00b00000000000000000000003000000000j00000000000000000000000pj000bb000000000333333333333333333333333333333333333333333333
33333333333000000000000000000000000003337770000000000000000000000300000000000000000000000033333333333333337773333000000000000000p0000000000000000000000000000000
3333333000000000000000000000000000000000000000000000000000000000030000000k000000000000000000000000000000000000000000000000000000000000o0000000000000000000000p00
33300000000000n0000n0000n00000000000000000000000000000000000000003000000000000000000000a00000000000o000000000000000000000000000k0000000000000b000000i00000000000
3300000000000333003330033300000000000000000000000000000000c00000030000000000000003333333333333333333330000333333333773333333333333300033333333773333333333333333
000000000000003000030000300000000000000000000000000000000b300000030000c00000000000000000000000000000000000000000000000000000000000000000000000000000000000000000
0000000000000030000300003000000000000000000000ac0000000003300000030000000000000000000a00000p000000000000k00000000000000o00000000b00000000000b0000000i00000000n00
000000000000003000030000300000000000p000000777770000000033300000000000000000000003333333337773333333333333333333300333333773333333333333000333333333333773333333
000000000000000000000000000000000000300000000000000000033330000000000000000000000000000000000000000p000000000000000000000000000000000000000000000000000000000000
0000000000300000000000000000000c0003330000j000k000000033333000000i0c00000000000000000000000g00000000j00000000k00000000p000000000c0000000000000000000i000k0000c00
3333333333333333333333333333333333333333333333333333333333333333333333333333333333333333333333333333333333333333333333333333333333333333333333333333333333333333