000000000000000000000000000000000000000000000000000000000000000000000000000222222
0000000000000000000000b0000000000000000000000000000000000000000000000000000000022
0000000000000000000000200000000000p0000b0000002000000b000000a00000000000000000002
00000000000000000000002666666666600066666666662000002200000020000000000000i000002
00000000000000000000000000000000000000000000002000b0000000002000000a0000002000002
00000000000000000000000000000000000000000j000020002000000022222000020000000000002
00000000000000000000000000002000000000000000000000000000000020000b020000000000002
00000000000000000000000200002000000j000020000000000000000000200002222200000000002
0000000000000000i0200b00000020000000j00020000020002000000000000000020000000000000
00000022222222222222222222222222222222222222222000222222000000b000b20000j00000o00
00002222222222222222222222222j22222222222222222pop2222222222222222222222222000000
222222222222222222222222222222222222222222222220102222222222222222222222222222222