0000pp000000000000000000000000000000a00000000000000000000000000000000000000000000
000055000000000000000000000111111111100000000000000000000a00000000000000000000000
0000000000000000000000000000000000000000000000000000000001000a00p0000000000000000
00555500000000000000000000000000000000011100000000000000000000010000000000fff0000
000000000000000000000000000000100000000000000000000000000000000000000000000000000
0000055000000000000000000000001000000000000000000a0000000000010000000000000000000
000000000000000000100000000000100000000000000000050000000000000000000000000000000
0000000005500000i11000f0000000000000000f00000000a00000000001000000000000000000000
000000000000000i11100000000000000000000000005555005000000000000000000000000000a00
00000055500000i11110000000000000000000000000000000000000010000000000000000000000a
00000000aaa00i1111100000000000150000000000000000000aa00000000000i0000000000000001
111111111111111111111111111111100001111110n01111111111111111111222111111111111111