0000000000030000000000000000000022000000000000000000000000000000000000000000000000000000000000000000000000000000000000000000000000000000000000000000000000222
00000000000300000000000000000000220000000000000000000000000000000000000000000000000000000000000000000000000000000000000000000000b0000000000000000000000000022
000000000003000000000000000j000022000000000000006600000000000000000000000000000000000o000000000000000b000000000000000000000200002000000000ob00000000000000002
00000000000000000000000a006600003300000000000000000000000000000000000000666000000000000000000000000666000000000000000g000002000020000000222220000000000000002
0000000000000000000000660000000003000000000000000000000000000i0000000000000000000000000000000000000000000000000000000000000200002000000000000000b0000000000p2
0000000000000000000000000000000000000000222200000000000022222220000000000000000000000100000000000000006660000000f000000000020000200000000000666660000000i0002
00000000000000000660000000000000000000000ip000000222000022000020000000000000000000060300220000000000000000000000000022000000000000000000000000000000000220000
0000000000000000000000000000000000000022220000000000000022000020000000000066000660000300000220000000000000000000000000000000006000000000222220000000000000000
000000000000000000000000000000j0000000000000000000000006222222200000000060000000000003000000000022000060000000220000000000i0000j00000000000000000000000000000
000000000000000000000000000222222000000000000i000000000p2200p000000000000000000000000300000000000000000000200000000000000222222222220000000000000000220000066
000000000002200222000222000000000002200000002200000000222200p0000j00j0000000000000000300000000000000022000000000000002200000000000000000000000000000000000000
2222222000000000000000000000000000000002200200000066000022222222222222200000000000000300000000000000000000000000000000000000000000000000000000000000000000000