00000000000000000000a0000000000000000000000000000000000000000003000000000000000000000000000000000000000000000000000000000000000n
00000000000b0000000660000000000000a00000000000000b00000000000003000000b000000000000000000000000000000000333333333333333333333333
0000000000000000000000000a000000066000b0000000006600000000b000030000066000000000000000000000000000066000333333333333333333333333
00000000000a0000000000006600000000000660000000000b000000066000030000000000000000000000000000000000000000333333333333333333333333
0000000000000000000000000000000000000000000000006600000000000003000000000000000000g000000000006000000000000000000000000000000000
000000000000000000000000000000000000000000000000000000a0000000030000000000000000000000000000000000000000000000000000000000000000
00000000000000000000000000000000000000a0000000000000033000000000000000000333000000333000000333000000000j0a00ba00a00b000a00ba00b0
00000000000b0000000000000000000000000000000a00000000000000000000000000b00030000b00030000b000300000000000333333333333333333333333
0000000000000033000000000000000000pp0000000000000000000000000i000000077000300077000300077000300000000003333333333333333333333333
00000000000000000000000000000000000000000000000000000000000002000000000000300000000300000000300000000033333333333333333333333333
0000000000000g0000000000000000000000000i0000000bb0000j0000002200000f00000030000p0003j00pi000300000000333333333333333333333333333
22222222222222222222222666666666600000666666666666666666666222222222222222322222222322222222333333333333333333333333333333333333