0000000000000e00000000000000000e0000000000000000e0000000e000000000000000000e000000000000000000000e0000000000000000000000000000e00000000000000ee0000000000000000000
000000000000040000000000000000040000000000000000400000004000000000000000000400000000000000000000080000000000000000000000000000400000000000000400000000000000000000
0000000000000000000000000000000000000000000000000000000000000000000000000000000000000000000000000000000000000000000000000000000000000000000000000000000p0l00000000
00000000000000000000000000000000000000000000000000000000000000000000000000000000000000on00000000000000000000088880000000000000000000000000000000000000080000000000
000000000000000000000000000000000000000000000000000000000000000000000000000000000000000000000000000000000000000000000088880000000000000000000000000000000000000000
000000000000000000000000000000000000000000l000000000o00l00000000000000000000000000000cccc000l00000000000000000000000i000000000000000000000c00000000000000000000l00
000000000000000000000000000000000000000000000000008888000000000000000000000000000000033330000000000000008800008888000000000e00000000008888888000000000000000008884
00000000000000000000000000000000l000000000000000000i00000000000j00000000000000k00800003300000000000000000000p00l000000000888800000000000000000000008800000i0000004
0000000000000000000000000004400000000088000088800000000008880008880000000000888000000033000008888000000088880000000000000000000000oe000000000000000000000880000004
000000000000000000000l440000000000i0000000000000000000000000000000000088000000000000003300000000000000000000000000000000000000008888000000000000000000000000000004
000000000000444440000000000000044440000000000000000000000000000000000000000000000000003300000000000008800000000000000000000000000000000000000000000000000000000004
888888880000000000000000000000000000000000000000000000000000000000000000000000000000003300000000000000000000000000000000000000000000000000000000000000000000000004