00000000000000000000000000000000000000000000000000000000000pp0000000000000000000000000000000000000000000000000000000000000000000000000000000000000000000
00000880000000000000000000000000000000000000000000000000000000000000000000000000000000000000000000000000000000000000000000000000000000000000000000000000
00000000000000000880000088000000000000000000000000000000000000000000000000000000000000000000000000000000000000000000000000000000000000000000000000000000
088000000gg00000000000000k00000c0000000000aa00000000000000088000aaa00000000000000000000d0000000000000000000000000000000000000000000000000000000000000000
0000000000000000000000000000008800000000088000000000000000000000000000000000000000000011000000000000000000000d000000000e00000000000000000000000000000000
0000000000000000000008800000000000000000000000000000000000000000000000000000000000000000000000000000000000000000000000000000000000e000000000e0000000e000
00000000000000000000000000000000000000000000000000008800000000000000000000000000e000000000000000000000000080000000d000000000000000e000000000d0000000d000
0000000000000000008800000000d0000000c00000000e8800000000000888e888000000j0000000000000o0000000000000000000000g00000000000000000000e000000000c0000000c000
0000000000a00000000000000000d0000000c00000000e000000i00000000000000000000000000000001111100000000000004400000000000000000d00000000e000000000b0000000b000
0000000000000000000000000000d0000000c00080000e00000088000000000000000000000j00000000000000d0000000000004000000000000000000000040000000000000a0000000a000
00000000000000000000jj000000d0000000c00000000e0000000000000e000000000000000000h000010ppp0110000000000004000000000000000000000000000400000000000000000000
44444444444444444444444444444444444444444444444444444444444444444444444444444444444444444444444444444444444444444444444444444444444444444444444444444444