000000000000000000000000000000000000000000000010000000000000000000000000000000001
0000000000000000000000000000000000000000000000100000p0000000000000000000000000001
000000000000000a00000000000000000000000000000015500000000000000000000000a00000001
000000000000000000000000000000000000000000000010000000000000000000000000000000p01
0000000000000000000000000000000000000aaa00000015500i00000000000000000011100000001
0000000050000000000a0000000011111111111111001110000100000000000000a000i0000000001
00000000000000005550005500000000000000000000000050000000000000000010111000000aa01
0000000000000000000i0000000000000000000000000000000i00000000000001100000000011111
00000050000000010001000000000a0000000000000000055001o0000000000011100000000000000
0000000000000001000000000000000000000o000000000000000000000000i111100000000000000
000000000001000000000000000000000pp0000000i00000000000000000001111100o00000000000
111111111111111111111111555555000550005555111111111111111111111111111111111111111