2000a00000000000000000000000000000000000000000000000000000000000000000000000000000000000000000002222
111110000002200000000000000000i0000000000000000002b0000000000000000000b00000000000000000000000000222
1100000000000n00000000000000002200000000000000000022000000000000000000220000000000000000000000000022
2000000000000000000000000000022000000b0000000000000000000000000000000000000000000000000000000000222
200000000022660000002000000000220000022000000000000000000000000000000000000a0000000000000i000000p022
200000000000000000000000000000220000000000000000000000000j000a00000000000022002200022000220000220002
2000000022000066000000000000002200000000b00002200000000220002200000000220000000000000000000000000002
200000000000000000000ij000000000220000000020000000000000000000000000000b00000000000000000000a0000000
2000000000000066222222200000000022666222220000000000220000000000000222222220000000000000000000000000
0000000000200000222222226620000000000i20000000000000000000000000006220000000000000000000000000000000
000000000220000pp00000i0002000000000i2200o0000000a0000000a0000000000000000000000220000000000i0000002
2222200002260066222222222220022222222222266222222222222222222002222222222200200000002200002222222222