3333333333300000000000000000000000000000000000000000008800000000008800000000000000000000000000000000000000000000000000000000000000000000000000000000000000000
333333300000000000000000000000000000000000000000000000000000000000000000000000000000008800000000000000000000000cp00000000000000000000000000000000000000000000
33330000000g000000008800000000000000000c000000000000000000000000000000000c000000000000000000c0000000000000000088000000000c00000000000000000000000000880000000
3000000000880000000000000000000000000088000000000b0088000000000a000000000000000000000000000000000000000000000000008000008800000000000000000000d00000000000000
300d0000000000000000g0000000000000000000000000000000000000000000000000000000000000000000000000000000000000000000000000000000000000000000000008800000000000000
3333000000000000000770000f00000007700000000008800000000o000000000000000000h0000000000000000000000000000000000000000000000000000000000000000000000000000000000
30000000000d00000000000007000000000000000000000000k0000000000000000000000000000000000000000000000000000i00000000000000000000000000000008800000000000880000000
00000000007700000000f0000000000000000000000000jj00000j0000000ddddd000000000000000000000004444000000000440008800000i000000088000000000000000000000000000000000
0000077000000000000000000000j000d000000033333333333333333333333333333333333344444444400000000000000000000000000088800000000080000000008800000000f000000000044
0000000000000003333333333333333333333333333333333333333333333333333333330000000000000000000000000444000000088000000000880000000044000000000088000000000044004
0000000000033333333333333333333333333333333333333333333333333333333330000000000000000000000000000000000000000000000000000000000000000000000000000000880000004
3333333333333333333333333333333333333333333333333333333333333330000000000000000000000n000000000000000000000000000000000000000000000f0000000000000000000000004