00000000000000000000000000000000000000000000000000000033000000000000000000000000000000000000000000pp00000000000000000000000000000000000000000000033000000000000003
0000000000000000000000000000000000000c000000000000000033000000000000000000000000000000000000033333333000000000000000000000000000000000000000f000033000000000000003
0000000000000000000000000000000c00000700000000000000003300000000000000000000000000000000000003000bb000000b00000000000000000000000000000000000000033000000000000003
00000000000000000000000000c0000700000000000000000000003300000000000000000000000000000000000003003333003333000000000000000000000000000a00000000000330000000000b0003
00000000000000000000000c00700000000000000000000000000033000000000000000000000000000000000000i30000000000000000000000000000000000000000a000000000033000003300000003
000000000000c00000c000070000c000000000000000000000000033000000000oo00000000000c000000003000033333330033700000000000000000000000i0000000a0000000c000000000000000003
000000000000c00000c000000000700000000000000000jc0000003300000000033000000000033000000030000000000000000000000000000000000000003300000000a0000000c00000000000000000
000000000000c00000c000000000000000000000330000330000000000000003333330000000033000000300000000000000000070000000000000000000003300000000000000000c0000000000000000
000000000000c00000c00000c000000000000000330000330000000k0000o00003300000c0003330000000000000000000000p00000i00000000000000000003000000000000000000c000000000000000
000000000000000000000000700000000003300033000033000000330000c0000330000330000330033000000000000000000003003300000000000000000000000000000000000000000000000000000g
0000oo000000000000000g000000000j000330003300003300330033000330000330770330c00330033000000000000i00030000000000000cc00000cc00003300000000000000000000000a00k0000030
333333333333333333333333333300770003307033070033073300330703307703300003307003300330000003333333333333333333333333333333333333333333333333333333333333333333333330