100000000000000000000000000000000000000000000001111000000000000100000000001
000000000000000000000000000000000000000000000000000000000000000000000000000
000000000000000000000000000000a00000000000000000000000001a00000000000000000
00000000000000000000000000000155000n000000000000000000001111100000000000000
0000000000000000000000000000100000000000000000000000000000000000a0100000000
000000000000000000000000000100000000000000000000000000000000011000100000000
0000000000000000000000000010000000000000000000000000000000000000a0100000000
000000000000000000111555110000000500000000i000000000000a0000000000000000000
000000011000000a000000000000000000000000011100000000a0000000000000000000000
000000000000000100000155000000000000000000o00000000010000000001000000000000
0000000000000011000000p0000i000000000000000000a0000010000000o00000000000001
111111111111111111111111111111100111111111111111111111111111111111111111111