0000000000000000000000000000000000000000b0c00000000000000000000o000000000000000000000300bbb000000000000000000000000000000000000000000000000000000000000000000
000000000000000000000000000000000003333333333000000000000000030303000000000000003333333333300000000000000000000000000000000000000000000000000000000000c000c00
0000000j00000000000000000000000000000000000003000000003030000333330000303000000300000000000000000000000000000000000000000000000000000000000000000333333333333
00000000000000000000000000000000000000000000003000000033300000030000003330000030000000000000000000000000000000000000000000000j00c0000000000000000000000000000
000000000000000000k00000000000000000000000000003000000030000000300000003000003000000000000000000000a000000000000003333333330033333333300000000000000000000000
000000000000k00000700000000000000g00000000000000333333333333333333333333333330000000000000000000000a000000000000000030000000000000030000000000000000000000c00
0000000000007000000000000000000000000000000000000c0000000c00000c0000c000000c000000000000000000000000000000000033000030000077770000030000003000000333333333333
0000000000000000000000000000000000300000000000000c0000000c00000c0000c000000c00000000000i000000000000p00ii00000330000300000000p0000030000003000000000030000000
0000000007000000030000000000000000300030000000000c0000000c00000c0000c000000c000000000033333333333333333333330033000030000000077000330000003333300000030000000
00000000000000000030000003j00000303000300000000033333333333333333333333333333000000030000000300000000030000000330000300000000000003pp000000000000000030000000
000000000000000300030000003c0003003030303000000300000000000000000000000000000300000030000000300000000030000000330000300000000000003pp0000000c0aaaaa0030000000
7777777777770000300030000003003000300030003333300000000000000000000000000000003333003000000030000000003000000033000030000000000000333000007070777770030000000