00000000000000000000000000000b00000000000b000000000000000000000000000000000000000000000000000000000000000000000000022
0000000000000000000000000001eb0000000001dd0000000000000000000100dddd0000000000000000000000000000000000000000000000002
00000000000000000000000000011100000000011100000000000000000001111111000000000000000000cc00000000000000000000000000002
000000000000d00040000000000000000000000000000a0000000000000000000000d0000000000000000111000000ddd00000000000000000002
000000000000d0000000000000000040000000000000040000000000000000000000c000000000000000000000000000000000000000000000002
00000000001ab000000400000000000000000000000000000000000000000c000001100000000000000000000000000000000a000000000000002
00000000001110000000000000e00000c00000000a00000000000d0000000c0000000000000a0000b0000d0000000000c0000a000000000000000
00000000000000000000c00000000000c000000a00000000000000000000000000000000000a0000b0000e00000d000000000d000000000000000
00000nnn000000000000c00000000000c0000000000000001100000000000000000e0000000a0000b0000b000e00000000000b000000000000000
00000000000000000000c00000c00000c00000000b00c0000000000000c0000000000000000a0000b0000a0000000d0000000a000000000000000
000000010000a0000000c00000100000c0000000000000000000000000c000000d000d00000000000000000000000d0000000d000000000000000
111111111111144444444444411444444444444444444444444444444444444444444444444444444444444444444444444444444444444442200